○ ○ ○ ○ ○ ○ ○ ○ ○ ○ ○ ○ ○ ○ ○
○ # # ○ ○ # # ○ # # # # # ○ ○
○ ○ # # ○ # ○ ○ ○ ○ ○ ○ # ○ ○
# ○ ○ ○ ○ # # ○ ○ # # # # ○ ○
○ ○ ○ # ○ # # ○ # ○ ○ ○ ○ ○ ○
○ ○ ○ # ○ ○ ○ ○ # ○ ○ ○ ○ ○ ○
○ ○ ○ ○ ○ ○ A ○ ○ ○ ○ ○ ○ ○ ○
○ # ○ # # ○ # # # ○ ○ ○ ○ ○ ○
○ ○ ○ ○ # ○ # ○ ○ ○ ○ ○ ○ ○ ○
○ # # ○ ○ ○ ○ ○ ○ ○ ○ ○ ○ ○ ○
○ ○ ○ ○ # # ○ ○ ○ ○ ○ ○ ○ ○ ○
○ ○ ○ ○ ○ # ○ # # # # # # # ○
○ ○ ○ ○ ○ ○ ○ ○ ○ ○ ○ ○ ○ ○ ○
○ ○ ○ ○ # # # ○ ○ ○ ○ ○ ○ ○ ○
○ ○ ○ ○ ○ ○ ○ ○ # ○ ○ ○ ○ ○ ○
○ # # # ○ # # # # ○ ○ ○ ○ ○ ○
○ ○ # ○ ○ ○ # ○ ○ ○ ○ ○ ○ ○ ○
# ○ # ○ ○ ○ # ○ # ○ ○ ○ ○ ○ ○
# ○ ○ ○ ○ ○ ○ ○ # ○ ○ ○ ○ ○ ○
○ Z ○ ○ ○ ○ ○ ○ ○ ○ ○ ○ ○ ○ ○