A ○ ○ ○ ○
○ # # ○ ○
○ ○ # # ○
# ○ ○ ○ ○
○ ○ ○ ○ Z