○ ○ ○ ○ ○ ○ ○ ○ ○ ○
○ # # A ○ # # ○ # ○
○ ○ # # ○ # ○ ○ ○ ○
# ○ ○ ○ ○ # # ○ ○ ○
○ ○ ○ # ○ ○ # ○ # ○
○ ○ ○ # ○ ○ ○ ○ # ○
○ ○ ○ ○ ○ ○ ○ ○ ○ ○
○ # ○ # # # # # # ○
○ ○ ○ ○ # ○ Z ○ ○ ○
○ ○ ○ ○ ○ ○ ○ ○ ○ ○